R 1200  750


NO ./textures/xpm/colorstone.xpm
SO ./textures/xpm/greystone.xpm
EA ./textures/xpm/purplestone.xpm
WE ./textures/xpm/bluestone.xpm
S ./textures/xpm/barrel.xpm
C ./textures/xpm/wood.xpm
F ./textures/xpm/mossy.xpm



        1111111111111111111111111
        1000000000110000000020001
        1011000001110020000000021
       11001000000000000002000021
111111110110000011100000200000011
100000000011000001110111111111111
11110111111111011100000010201
11110111111111011101010010001
11000000110101011100000000021     1111
10000000000000001102000000111    110011
10002000000100201101010010001   1100001
11000001110101011111011110E01    110011
11110111 1110101 101111010221     1111
11111111 1111111 111111111111
