R 1200  700

NO ./textures/xpm/colorstone.xpm
SO ./textures/xpm/greystone.xpm
EA ./textures/xpm/purplestone.xpm
WE ./textures/xpm/bluestone.xpm
S ./srcs_bonus/txts/teleport.xpm

C 114,71,50
F 0,71,68




111111111111111111111111111111111
100000000000000000000000000000001
100000000000000000000000000000001
100000000000000000000000000000001
100000000000000000000000000000001
100000000000000000000000000000001
100010000000000000000000000010001
100001000000000000000000000100001
100000100000000000000000001000001
100000010000000000000000010000001
100000001000000000000000100000001
110000000100000000000001000000011
 1100000001000002000001000000011
  11000000000000000000000000011
   110000000000000000000000011
  11000000000000000000000000011
 1100000010000002000000100000011
110000000000000000000000000000011
100000010000000000000000010000001
100000000000000000000000000000001
100001000000000000000000000100001
100000000000000000000000000000001
100000020000000020000000020000001
100000000000000000000000000000001
100000000000000000000000000000001
100000000000000000000000000000001
1E0000000000000000000000000000001
111111111111111111111111111111111
