SO ./textures/xpm/purplestone.xpm

EA ./textures/xpm/greystone.xpm

NO ./textures/xpm/purplestone.xpm

F 128   			   ,      128     , 			0
WE ./textures/xpm/colorstone.xpm

S ./textures/xpm/pillar.xpm

C 192,192,192
R 5400 5200

 11111111111111111111111
 10000020000000000020001
 10000000000000000000001         11111111111111111111
 10200000000200000000001         10000000000000000001
 11111111111111111110111         10111111111111111101
                   101           101              101
                 11101111111111111011111          101
                 10000000000200000000001   111111110111111111111111111111111
                 12000000000000000000001   100020000002000000000000000000001
                 10000000000000000020001   100000000000000000000000000000001
                 11111111111111111111111   120000000000000000000000000000021
                                           100000000000000000000000000000001
                                       1111100000000020000000000000000000001
                                       1000000000000000000000000200000200021
     11111111111                       1011100020000000000000000002020000001
     10000000001                       101 111111111111111111111111011111111
     11000000011                       101                        101
      110000011                     111101111                     101
       1100011                      100000021                     101
        11011                       102000001                     101
         111                        100000001                     101
                                    102002001                     101
                                    111111111                     101
                                                                  101
                                                                  101
                                                                  101
                                                                  101
                                                                  101      1      1111    1
                                                                  101      1     110011   1
                                                                  101      1    11000011  1
                                                                  101      1     110011   1
                                                                  101      1111   1111    1111
                                                                  101
                                                                  101
                                                                  101
                                                                  101
                                                                  101
                                                                  101
                                                                  101
                                                                  101
                                                                  101
                                                                  101
111111111111111111111111111111111111111111111111111111111111111111101
100000000000000000000000000000000000000000000000000000000000000000001
102002002002002020020020020020200200200200202002002002002002002000111
10000000000000000000000000000000000000000000000000000000000000000W1
1020020020020020200200200200202002002002002020020020020020020020001
1000000000000000000000000000000000000000000000000000000000000000001
1020020020020020200200200200202002002002002020020020020020020020001
1000000000000000000000000000000000000000000000000000000000000000001
1020020020020020200200200200202002002002002020020020020020020020001
1000000000000000000000000000000000000000000000000000000000000000001
1020020020020020200200200200202002002002002020020020020020020020001
1000000000000000000000000000000000000000000000000000000000000000001
1020020020020020200200200200202002002002002020020020020020020020001
1000000000000000000000000000000000000000000000000000000000000000001
1020020020020020200200200200202002002002002020020020020020020020001
1000000000000000000000000000000000000000000000000000000000000000001
1020020020020020200200200200202002002002002020020020020020020020001
1000000000000000000000000000000000000000000000000000000000000000001
1020020020020020200200200200202002002002002020020020020020020020001
1000000000000000000000000000000000000000000000000000000000000000001
1020020020020020200200200200202002002002002020020020020020020020001
1000000000000000000000000000000000000000000000000000000000000000001
1111111111111111111111111111111111111111111111111111111111111111111
