R 1080 750


NO ./textures/xpm/colorstone.xpm
SO ./textures/xpm/greystone.xpm
EA ./textures/xpm/purplestone.xpm
WE ./textures/xpm/bluestone.xpm
S 	./textures/xpm/barrel.xpm


C 1,130,233
F 128, 128, 128

        1111111111111111111111111
        1000000000110000000020001
        1011002001110020000000021
       11001002000000000002000021
111111110110002011100000200000011
100000000011N00001110111111111111
11110111111111011100000010201
11110111111111011101010010001
11000000110101011100000000021     1111
10000000000000001102000000111    110011
10002000000100201101010010001   1100001
11000001110101011111011100001    110011
11110111 1110101 101111010221     1111
11111111 1111111 111111111111
