R 1920  1080
NO ./textures/xpm/tubes.xpm
SO ./textures/xpm/straighs.xpm
EA ./textures/xpm/wall_txt.xpm
WE ./textures/xpm/wall_txt.xpm
S ./textures/xpm/barrier.xpm
C ./textures/xpm/ceiling.xpm
F ./textures/xpm/floor.xpm

111111111111111111111111111111111111111111111111111111111111111111111111111111111111111111111111111111111111111111111111111111111111111111111111111111111111111111111111111111111111111111111111111111111111111111111111111111111111111111111111111111111111111111111111111111
100012221444100010000000000000000000000000000000000000000000000000000000000000000000000000000000000000000000000000000000000000000000000000000000000000000000000000000000000000000000000000000000000000000000000000000000000000000000000000000000000000000000000000000000000001
103010201040106010500000000000000000000000000000000000000000000000000000000000000000000000000000000000000000000000000000000000000000000000000000000000000000000000000000000000000000000000000000000000000000000000000000000000000000000000000000000000000000000000000000000001
100000000000000000001111111111111111111111111111111111111111111111111111111111111111111111111111111111111111111111111111111111111111111111111111111111111111111111111111111111111111111111111111111111111111111111111111111111111111111111111111111111111111111111111111111111
100000000000000000011
10000000000000000011
1000000000000000001
1000000000000000001
1000000000000000001
1000000000000000001
1000000000000000001
1000000000000000001
1030011100N00000011
100011 11000000011
11111   111111111