R 1920  1080
NO ./textures/xpm/tubes.xpm
SO ./textures/xpm/straighs.xpm
EA ./textures/xpm/wall_txt.xpm
WE ./textures/xpm/wall_txt.xpm
S ./textures/xpm/barrier.xpm
C ./textures/xpm/ceiling.xpm
F ./textures/xpm/floor.xpm

        111
       11S11                              111
   1111100011111                         11611
  110002000200011                       1100011
  100002000200001                       1000001
  110002000200011                       1000001
   1110200020111                        1000001
     111000111                          1003001
       11011                            1111111
        151
       11011
      1100011
     110000011
    11000000011
   1100000000011
  110000000000011
 11000000000000011
1100000000000000011
1000000000000000001
1000000000000000001
1040000000000000001
1000000000000000001
1000040000000000001
1000000000000000001
1222222240000000001
1000000000000000001
1000000000000000001
1000000000000000001
1000000000000000001
1000000000000000001
1000000000000000001
1000000000000000001
1000000000000000001
1000000000000000401
1000000000000000001
1000000000000000001
1000000000004000001
1000000000000000001
1000000000000000001
1000000004000000001
1000000000000000001
1000000000000000001
1000000000000000001
1000000000222222221
1000000000000000001
1000000000000000001
1000000000000000001
1000000000000000001
1000000000000000001
1000000000000000001
1002000000000000001
1000000000000000001
1000200000000000001
1000000000000000001
1000020000000000001
1000000000000000001
1000002000000000001
1000004000000000001
1000000200000000001
1000000000000000001
1000000020000000001
1000000040000000001
1000000002000000001
1000000000000000001
1000000000000000001
1000000000000020001
1000000000000000001
1000000000000200001
1000000000000000001
1000000000002000001
1000000000000000001
1000000000020000001
1000000000000000001
1000000000200000001
1000000000000000001
1000000002000000001
1000000004000000001
1000000020000000001
1000000000000000001
1000000200000000001
1000000400000000001
1000002000000000001
1000000000000000001
1000000000000000001
1000000000000000001
1000000000000000001
1000000000000000001
1000000000000000001
1000000000000000001
1000000000000000001
1000000000000000001
1000000000000000001
1000000000000000001
1000000000000000001
1000000000000000001
1000000000000000001
1222000004000002221
1000040000000400001
1000000000000000001
1000000000000000001
1000000000000000001
1000002222220000001
1000000000000000001
1000000000000000001
1000000000000000001
1000000000000000001
1000000000000000001
1000000000000000001
1000000000000000001
1000000000000000001
1000000000000000001
1000000000000000001
1000000000000000001
1000000000000000001
1404040000000000001
1000000000000000001
1000000000000000001
1000000000000000001
1000000000000000001
1000000000000000001
1000000000000000001
1000000000000000001
1000000000004040401
1000000000000000001
1000000000000000001
1000000000000000001
1000000000040000001
1020000000000000001
1002000000004000001
1000200000000000001
1000020000000000001
1000002000000040001
1000000200000000001
1000000020000004001
1000000002000000001
1000000000200000041
1000000000020000001
1000000000002000001
1000000000000200001
1000000000000020001
1000000000000000001
1000000000000000001
1000000000000000001
1000000000000000001
1000000000000000001
1000000000000000001
1000000000000000001
1000000000000000001
1000000000000000001
1000000000000000001
1000004000000000001
1000000000000000201
1000040000000002001
1000000000000020001
1000400000000200001
1000000000002000001
1040000000020000001
1000000000200000001
1400000002000000001
1000000020000000001
1000000200000000001
1000002000000000001
1000020000000000001
1000200000000000001
1000000000000000001
1000000000000000001
1000000000000000001
1000000000000000001
1000000000000000001
1000000000000000001
1000000000000000001
1000000000000000001
1000000000000000001
1000000000000000001
1000000000000000001
1000000000000000001
1000000000000000001
1200000000000000021
1000000000000000001
1002000000000000201
1000000000000000001
1000200000000002001
1000000000000000001
1000000000000000001
1000000000000000001
1000000000000000001
1000000004000000001
1000000000000000001
1000000000000000001
1000000000000000001
1040000000000000401
1000000000000000001
1000000000000000001
1000000024200000001
1000000000000000001
1000000000000000001
1040000000000000401
1000000000000000001
1000000000000000001
1200000000000000021
1000000000000000001
1020000000000000201
1000000000000000001
1000000020200000001
1000000000000000001
1000000000000000001
1000000000000000001
1000000000000000001
1000000000000000001
1000000000000000001
1000000000000000001
1000000000000000001
1000000000000000001
1000000000000000001
1202020000000202021
1000000000000000001
1000000000000000001
1000000000000000001
1000004000004000001
1000000000000000001
1000000000000000001
1000000000000000001
1000000000000000001
1000400000000040001
1000000000000000001
1000000000000000001
1000000000000000001
1000000002000000001
1000000000000000001
1000000000000000001
1000000000000000001
1000000000000000001
1000000000000000001
1002000000000002001
1020000000000000201
1200000000000000021
1000000000000000001
1100000000000000011
 11000000000000011
  110000000000011
   1100000000011
    11000000011
     110000011
      1100011
       11011
      1100011
     110000011
    11000000011
   1100000000011
  110000000000011
 11000000000000011
1100000000000000011
1000000000000000001
1000000000000000001
1000000000000000001
1000000000000000001
1000000000000000001
1000000004000000001
1000000000000000001
1000004000004000001
1000000000000000001
1000040000000040001
1000000000000000001
1000004000004000001
1000000000000000001
1000000004000000001
1000000000000000001
1000000000000000001
1000000000000000001
1000000000000000001
1000000000000000001
1000000000000000001
1000000000000000001
1000000000000000001
1000000000000000001
1000000000000000001
1000000000000000001
1000000000000040001
1000000000000000001
1000000000000000001
1000000000000000001
1000000040000000001
1000000000000000001
1000000000000000001
1000000000000000001
1000000000000000001
1000400000000000001
1000000000000000001
1000000000000000001
1000000000000000001
1000000000000000001
1000000000000000001
1000000000000000001
1000000000400000001
1000000000000000001
1000000000000000001
1000000000000000001
1000000000000000001
1000000000000040001
1000000000000000001
1000000000000000001
1000000000000000001
1000000000000000001
1040000000000000001
1000000000000000001
1000000000000000001
1000000000000000001
1000000000000000001
1000000000000040001
1000000000000000001
1000000000000040001
1000000000000000001
1000000000000040001
1000000000000000001
1000000000000040001
1000000000000000001
1000000000000040001
1000040000000000001
1000000000000000001
1000040000000000001
1000000000000000001
1000040000000000001
1000000000000000001
1000040000000000001
1000000000000000001
1000000000000000001
1000000000000000001
1000000000000000001
1000000000000000401
1000000000000000001
1000000000000000401
1000000000000000001
1000000000000000401
1000000000000000001
1000000000000000401
1000000000000000001
1000000000000000001
1000000004000000001
1000000000000000001
1000000004000000001
1000000000000000001
1000000004000000001
1000000000000000001
1000000004000000001
1000000000000000001
1000000000000000001
1000000000004000001
1000000000000000001
1000000000004000001
1000000000000000001
1000000000004000001
1000000000000000001
1000000000004000001
1000000000000000001
1040000000000000401
1000000000000000001
1040000000000000401
1000000000000000001
1040000000000000401
1000000000000000001
1040000000000000401
1000000000000000001
1100000000000000111
 1000000000000111
 10000000000111
 100000000111
 1000000111
 10000111
1100011
1000011
1000011
1000011
1000011111
1000000001111
1000000000001111
1000000000000001111
1000000000000000001
1000000000000000001
1000000000000000021
1000000000000000001
1000000000000002001
1000000000000000001
1000000000000200001
1000000000000002001
1000000000020000001
1000000000000002001
1000000002004000001
1000000000000002001
1000000000020000001
1000000000000002001
1000000000000200001
1000000000000000001
1000000000000002001
1000000000000000001
1000000000000000001
1000000000000000001                   111
1004000000000000001                   131
1000000000000000001                   101
1000000000000000001                   101
1000000000000000001                   101
1000000000000000001                   101
1000000000000000001                   101
1000000000000000001                   101
1000000000000000001                   101
1000000000000000001                   101
1000000000000000001                   101
1000000000000000001                  11011
1000000000000000001                  14001
1000000000000000001                  10001
1000000000000000001                  10001
1000000000000000001                  10001
1000000000000000001                  10001
1000000000000000001                  10041
1000000000000000001                  10001
1000000000000000001                  10001
1000000000000000001                  10001
1000000000000000001                 1100011
1020000000000000001                 1200021
1000000000000000001                 1000001
1000200000000000001                 1000001
1000000000000000001                 1400041
1004000200000000001                 1000001
1000000000000000001                 1400041
1000200000000000001                 1000001
1000000000000000001                 1400001
1020000000000000001                 1000001
1000000000000000001                110000011
1000000000000000001                120000021
1000000000000000001                100000001
1000000000000000001                100000001
1000000000000000001                100000401
1000000000000000201                140000001
1000000000000000001                100000001
1000000000000000001                100000001
1000000000000000001                100000001
1000000000000004001                100000001
1000000000000000001               11000000011
1000000000000400001               10200000201
1000000000000000001               10000000001
1000000000000000001               10000000001
1000000000000000001               10040004001
1000000000000000001               10000000001
1000000000000000001               10000000001
1000000000000000001               10000000001
1000000000000000001               10000000001
1000000000000000001               10000000001
1000000000000400001              1100000000011
1000000000000000001              1020000000201
1000000000000000001              1000000000001
1000000000000000001              1000000000001
1000000000000000001              1000200020001
1000000000000000001              1000000000001
1000000000000004001              1004000004001
1000000000000000001              1000000000001
1000000000000000001              1000000000001
1000000000000400001              1004000004001
1000000000000000001              1000000000001
1000000000000000001              1000000000001
1000000000000000001              1040000000401
1000000000000000001              1000000000001
1000000000000000001              1000000000001
1000000000000000001              1000000000001
1000000000000000001              1000000000001
1000000000000000001              1000000000001
1020000000000000201              1000000000001
1000000000000000001              1000000000001
1000000000000002001              1000000000001
1000000000000000001              1000000000001
10020000000000000011             1020002000201
100000000000000200011            1000000000001
1000000000000000000011          11000000000001
100020000000000000000111      1110000000000001
1000000000000000020000011111111000200000000001
1000200000000000000000000000000000000000000001
1000000000000000000000200000020000000000000201
1000020000000000000000000000000000000000000401
1000000000000000000000000000000000000000000001
1000002000000000000000000000000000000000200001
1000000400000000000000000000000000000000040001
1000000000200000000000000000000000002000000001
1100000004000000000000000000000000000040000001
 110000000000200000000000000000200000000000001
  11111000040000000000000020000004000000000001
      1100000000020000200000000000000004000001
       111100004000040004000040000000000011111
          11110000004000000004000001111111
             11111111111111111111111